第四节 经营情况讨论与分析

一、经营情况讨论与分析
报告期内公司全年实现营业收入 6.39 亿元，较 2018 年增长 19.46%，净利润 0.85 亿元较
2018 年下降 20.72%。
2019 年公司董事会紧紧围绕既定战略目标，充分利用有效资源，深化内部改革，推动产品结 构调整，积极拓展新产品、新业务，优化市场布局，加强品质管理，强化研发工作，加大人才培 养力度，提升运营效率，促进了公司的健康持续发展。
报告期内公司完成了以下主要工作：

1、优化销售团队结构、拓展产品市场 为更好地适应市场变化和公司发展需要，经公司管理层讨论，对公司整体销售系统结构进行
优化调整，将原各销售大区、代表处，合并为北区运营中心、东区运营中心、南区运营中心三大
运营中心集中管理，同时加强推进机房环境一体化产品、磁悬浮冷水机组产品、微模块、RDS 的 市场拓展，其中机房环境一体化产品 2019 年度营业收入 1.22 亿元，冷水机组产品实现营业收入
4,893.91 万元，较 2018 年增长 147.10%。机房环境一体化产品系公司在 2018 年开始拓展的新 业务，包括新型末端产品和智能冷站两个产品系列，新型末端产品为客户数据中心提供机房内整 体解决方案，新型末端产品集成空调、机柜、配电等模块，实现工厂内预制，工厂预测，实现快 速安装，便于分期部署，大大缩短了安装周期。佳力图智能冷站系列产品为数据中心等场所提供 整体冷源解决方案，将磁悬浮冷水机组、冷却水泵、冷冻水泵、定压补水装置、配电及控制系统 集成在定制箱体内，同时集成了冷却塔散热单元，所有模块在工厂内组装完成，并进行系统测试， 到达现场后即可投入使用。佳力图智能冷站产品无需制冷机房，减少了对建筑空间的依赖，大大 提高了水冷系统在数据中心的适用范围。
2、加强内部控制的执行，完善公司治理 依据《公司法》、《证券法》、《上海证券交易所股票上市规则》、《公司章程》等相关法
律法规及规范运作指引，加强公司内部控制治理，加强信息披露，执行和完善管理体系，激励与
约束管理体系，品牌管理，资质管理和企业形象、企业文化管理体系，信息化管理与执行管理和 行政管理体系。
3、推进“南京楷德悠云数据中心项目”，促进公司产业结构延伸 随着国家对战略性新兴产业的重视，对云计算、下一代网络的积极推进，国内数据中心基础
设施市场迎来了前所未有的发展机遇。一方面，基于云计算的数据中心建设进一步推进，并成为
不少政府园区关注引进的重点，另一方面，基于移动互联网的应用发展迅速，SNS、电子商务、 视频等业务的大规模增加给数据中心基础设施市场带来了持续的需求。随着数据中心基础设施市 场的走强，中国数据中心基础设施市场增长速度仍保持较高的增长速度，对产品的需求仍然较为
旺盛。公司具有多年的数据中心等精密环境控制领域产品研发制造经验、信息机房环境保障经验、 数据中心基础环境设施维护经验，项目工程实施和售后服务经验。因此，佳力图在数据中心行业 具有先天优势。
鉴于以上市场需求及公司战略发展需要，经公司 2019 年第三次股东大会审议通过，拟投资
15 亿建设“南京楷德悠云数据中心项目”，项目产品及服务系为客户提供机柜租用及运维服务等 IDC 基础服务，总体建设 8400 标准机架机柜。该项目将促进公司在大数据服务产业下游的延伸 发展，并进一步加大核心技术的研发。
南京市人民政府宁委发[ 2020 ]17 号《关于印发应对新冠肺炎疫悄影响新基建新消费新产业 新都市“四新“行动计划的通知》中将“南京楷德悠云数据中心项目”认定为新基建及关联产业 重大项目。

项目具体内容及进度已经以临时公告形式披露，具体详见公司在法定披露媒体披露的相关公
告。
4、完善激励体制，实施 2019 年度股权激激励计划

在原有的薪酬激励体制基础上，公司董事会制定并执行了《2019 年限制性股票激励计划》， 形成以基本薪酬保障员工基本收入、以年度业绩薪酬提高员工工作积极性保证年度计划顺利实施、 以股权激励支持公司长远发展的全面薪酬激励体系，促进全体员工、管理层、公司和股东利益的 一致性，改善公司治理，激励员工更好创造价值，实现员工与股东价值最大化，吸引和激励核心 人才团队，提高行业竞争力。
5、加强产品及技术研发，提升核心竞争能力 创新技术研发是保障公司竞争优势的关键。报告期内公司继续加强技术研发团队建设，加强
与高等院校、行业专家等机构、人士的合作，推动尖端理论研究和实践，依托现有的研发体系，
充分发挥节能控制方面的技术优势，加快机房智能节能管理系统的研制，进一步提高公司产品的 性能指标，加强在空调换热器效率提升、供配电技术方面的基础性研究实力，全面提升公司在机 房环境控制一体化解决方案方面的创新能力，更好更全面地服务于客户。
截止报告期末公司拥有的核心技术由 14 项增加至 23 项，同时有包含高能效机房空调、高能 效基站空调、高精度微型定点制冷机组、数据中心冷冻站集中控制系统、机房空调 VRF 系统、CPU 液冷技术等二十余项在研项目，具体如下：

核心技术情况：

序号 	 技术名称 	 技术描述 	 技术来源 	 
1 	 机房群集控节能 系统 	 佳力图机房群集控节能系统采用广泛收集机房环境的温湿度 探头信息，集中模拟运算，综合管理机房内部的所有机房空调 	 自主研发 	 

序号 	 技术名称 	 技术描述 	 技术来源 	 
 	  	 设备，统一协调各个空调的运行方法，来解决机房空调设备间 的“不和谐”问题。该系统造价成本低，节能效果显著（经现场 实测可达 25%-35%），既可降低机房运行成本，也可降低旧 机房空调设备节能改造成本，施工简单，改造风险极低。 	  	 
2 	 机房一体化 RDS 管理系统 	 RDS 是“实时动态伺服智能管理系统（Real-time Dynamic Servo intelligent system）”的简称，是连续监测机房运行环境 变化趋势，以机房环境实时数据为基础，启动机房整体空调设 备节能管理运行策略，来达到整体机房空调系统节能目的智能 管理系统。 RDS 集成管理系统平台主要由主体框架部分、冷站控制以及 机房末端设备子模块组成，可根据不同类型的建筑结构模型， 采取不同的独立运行的 RDS 子单元模块无缝对接组合，与客 户供需相结合，利用大数据分析智能预测机房负荷演变趋势， 最大化保持整体空调系统安全运行和节能。 	 自主研发 	 
3 	 机房空调氟泵节 能模块 	 IDC 机房环境在全年四季都需要提供制冷，在春冬季节自然界 存在着丰富的冷源，佳力图氟泵节能模块可不启动压缩机机械 制冷模式下最大限度利用大自然的自然冷源，提升空调机组的 全年能效比。当室外气温低于某一设定值时（一般可-5～+10℃ 范围设置），佳力图氟泵节能模块与机房空调设备配套使用， 启动氟泵节能模块代替压缩机致谢制冷，能效比可达 10-15W/W，体现显著的节能特性。并且佳力图公司已经获得 该项技术的发明专利。该模块的显著特点如下： 1、节能模块是利用原有机房专用空调的蒸发器和冷凝器，仅 增加一个不到一平方米的节能模块柜，尺寸紧凑，降低制造成 本； 2、设备安装方便，占用场地仅为其他自然制冷系统的 1/8， 维护成本大大降低； 3、高能效比，与压缩机制冷机型运行对比，全年节能率达 30% 以上；4、无水进入机房，避免漏水隐患，无需添加防冻液， 安全性高。 	 自主研发 	 

序号 	 技术名称 	 技术描述 	 技术来源 	 
4 	 定点制冷技术 	 定点制冷系统由一个直接制冷循环和一个间接制冷循环组成。 （1）直接制冷循环。被主机冷却的氟利昂液体回到贮液器， 由屏蔽泵输送到各制冷末端模块，氟利昂液体在换热器盘管内 蒸发吸收机柜排出的热量后，蒸发又回到制冷主机冷却，如此 不断循环，从而达到连续制冷的目的。 （2）间接制冷循环。间接制冷循环内的制冷剂或冷冻水，通 过制冷主机内的板式换热器吸收来自制冷末端的氟利昂气体 的热量，然后通过冷凝器、冷却塔等排出室外。 佳力图定点制冷系统的主要特点： （1）制冷主机特点：机组体积小，节省机房空间，布置灵活。 （2）制冷末端模块特点：安装方式灵活，有吊顶、立式和机 架上方安装。 （3）露点控制：采用环保冷媒作载冷剂，杜绝水进机房的隐 患，严格控制供液温度高于机房环境露点温度，确保末端无冷 凝水产生。 	 自主研发 	 
5 	 磁悬浮压缩机在 冷水机组产品中 的应用技术 	 针对现有制冷系统存在的问题和不足，佳力图开发了利用直流 	 自主研发 	 
变频磁悬浮压缩机作为制冷压缩机的自然冷源冷水机组，使用 	 
直流变频磁悬浮无油离心压缩机，实现了制冷系统完全无油运 	 
行，避免了复杂的润滑油系统，大大提高了机组的可靠性。由 于避免了回油的问题，可以使用高效满液式蒸发器，并且与直 流变频技术和自然冷源利用技术结合起来的自由冷却节能技 术，通过合理的管路设计、盘管设计、逻辑切换控制技术和压 	 
缩机直流变频调节技术，并将自然冷源利用与磁悬浮离心机组 	 
集成，从而降低设备投资和设备占地面积，为数据中心等全年 	 
制冷领域提供全方位的节能措施。 	 

序号 	 技术名称 	 技术描述 	 技术来源 	 
6 	 机房局部热点智 能回风装置控制 技术 	 目前，大多数数据机房空间较大，设备数量较多，在数据机房 设置回风风管，通过回风风管与空调机相连，形成完整的回风 通道。回风口与空调机相连接的风管长度、形式不一样，风管 的沿程阻力也会有所差别。距离空调机更近的回风口，回风效 果好，其附近的服务器温度情况良好，距离空调机更远的回风 口，由于风管的长度，以及用于连接的风管接头，增加了风管 的沿程阻力，导致回风量的衰减，部分服务器的热量无法正常 排出，设备出现过热现象。佳力图在不改变回风风管的前提下， 通过在回风口上增加智能回风装置，有效抵消回风风管沿程阻 力，使得整个风管系统中的风量满足服务器实际需求，避免因 风量不足引起的空调机组冷量不能正常输送，导致机房局部过 热。智能回风装置采用 EC 风机，并根据回风温度和回风静压， 对风机转速进行智能 PID 调节，有效的达到精准控制回风量 和节能的目的。 	 自主研发 	 
7 	 风冷直膨分体式 机房空调二次水 预冷节能技术 	 二次水预冷节能技术是指在原先标准风冷冷凝器的散热装置 	 自主研发 	 
上采取串联方式额外增加一套水冷式散热装置，起到辅助散热 	 
（有时可以承担主散热目的），保证风冷直膨系统可以在超高 	 
室外温度环境下正常运行。 二次水预冷节能技术的优点有： （1）降低热岛效应，解决机组夏季高温高压报警隐患，延长 机组寿命，减少维护成本； 	 
（2）减轻室外风冷冷凝机工作压力，降低室外机的机械噪音 	 
及空气流动噪音； 	 
（3）提高机组制冷效果。 	 
8 	 新风湿膜节能技 	 佳力图新风湿膜节能技术是公司自主研发的一项不带制冷循 	 自主研发 	 
环，利用室外自然新风，并对新风进行过滤，等焓加湿降温， 	 
风量调节等处理后，为通讯机房、数据机房提供天然冷量的一 	 
种技术。具有以下优点： 	 
术 	 （1）标准化落地式设计，结构紧凑，占据机房空间小； 	 
（2）具备辅助制冷功效，高效节能性； 	 
（3）新风与室内回风可智能混风处理，拓展了机组的应用范 	 
围； 	 

序号 	 技术名称 	 技术描述 	 技术来源 	 
 	  	 （4）加湿器具备先进的控湿策略，确保机房恒湿； 	  	 
（5）机组配备双效除尘装置，满足机房洁净度设计要求； 	 
（6）具备消防联动及远程通讯功能。 	 
9 	 高精度恒温恒湿 控制技术 	 高精度恒温恒湿控制技术是公司自主研发的新一代高精度机 	 自主研发 	 
房空调控制技术，其设计理念和构造填补了机房空调在这一领 	 
域的空白，它将传统机房空调的开关量控制改为无级线性控制 	 
和变频控制，使得机房空调的控制精度大大提高。该控制技术 	 
具有以下特点： 	 
（1）采用 PID 编程控制，能够准确地维持机房内部温度和湿 	 
度； 	 
（2）采用直流变频压缩机进行制冷和除湿，根据目标温湿度 设定值及其精度要求自动控制和改变压缩机工作频率，在保证 控制精度的同时，大大降低了机房空调的能耗； 	 
（3）采用电子膨胀阀控制系统代替传统的热力膨胀阀控制模 	 
式，为制冷系统的节能化运行提供了条件，大大提升了机房空 	 
调的机电一体化程度； 	 
（4）采用模拟量控制的加湿器系统，可以根据目标加湿需求 	 
线性化控制蒸汽输出量； 	 
（5）采用周波数调功能模块控制电加热，可以根据目标需求 	 
线性化控制输出加热量。 	 
10 	 数据中心模块化 建设技术 	 数据中心模块化建设技术是公司自主研发的新一代机房建设 	 自主研发 	 
技术，其理念是将工程产品化、预制化、模块化，提升机房的 	 
建设速度、降低机房的能耗、优化资本的投入，使得机房投资 可以分期进行，保护资本投入。数据中心集成配电、UPS、蓄 电池、布线、冷却、机柜、封闭通道、环境动力监控等功能， 	 
每一部分均是独立模块，可根据需求进行快速组合，并尽可能 	 
在工厂进行预制。 	 
11 	 节能型氟泵螺杆 冷水机组 	 本产品为公司螺杆式冷水机组的高效产品，旨在提升机组的 	 自主研发 	 
COP 和 IPLV，达到国家节能产品的要求。同时本产品首次将 氟泵式自然冷源技术应用于冷水机组。 1.为了提升冷水机组的综合能效比，本产品在现有风冷螺杆产 	 
品基础上，采用了以下新技术： 	 

序号 	 技术名称 	 技术描述 	 技术来源 	 
 	  	 （1）将变频技术应用于螺杆压缩机； （2）采用低压损、高效独立油分离器，优化油路系统； （3）采用高效降膜式蒸发器，结合气泵回油，高效、可靠； （4）风机分组与变频技术的合理结合。 2.冷水机组与氟泵式自然冷源结合，关键技术和产品优势如 下： （1）采用独创的氟泵系统，并与降膜式蒸发器合理匹配，提 高了产品的可靠性； （2）无专用盘管，风阻降低，风量提升，产品性能更加优异； （3）无自然冷专用盘管、乙二醇泵、板式换热器等部件，机 组系统结构简单，安装维护便利。 	  	 
12 	 磁悬浮并联式冷 水机组 	 机组最大制冷能力 900 冷吨；可以实现最大 6 台压缩机并联 控制，相互通讯，实现压缩机相互轮转；需要在开发过程中对 于制冷系统并联设计、降膜式蒸发器设计、冷媒两相分配、压 缩机之间通讯配合、压缩机相互轮转控制方面进行技术攻关。 磁悬浮并联式冷水机组按照名义工况进行测试可以达到国家 节能产品要求，IPLV 方面处于行业领先水准；此外噪音比传 统离心机组低 4 到 5 分贝，且维护费用低，无需专门的润滑油 系统，实现完全无油运行。 	 自主研发 	 
13 	 室外冷源机组 	 室外冷源机组系统可以完全杜绝水进入机房风险，适合高标准 机房制冷需求。将定点制冷技术集成在冷水机组中，将制冷剂 长距离输送。 开发设计目标及主要内容： （1）定点制冷技术与风冷冷水机组集成； （2）采用环保制冷剂 R134a； （3）双系统备份设计； （4）模块化设计方案； （5）集成自然冷源综合利用功能； 关键技术： （1）小负荷下稳定运行技术； （2）制冷剂远距离输送技术； （3）负荷动态匹配技术； 	 自主研发 	 

序号 	 技术名称 	 技术描述 	 技术来源 	 
 	  	 主要技术指标： （1）机组整体能效达到节能产品要求； （2）环温-40 到 45 度宽幅运行； （3）负荷从 12.5%-100%自由调节； 	  	 
14 	 工业性水冷磁悬 浮离心机 	 该随着国家对于环境保护和节能减排的重视，氧化、电镀等工 业领域对于冷却方案有了更高的要求；工业领域一般采用地下 水自然冷却、水冷螺杆等冷却方式，并且水温要求较高和全年 稳定可靠运行；地下水自然冷却大量消耗宝贵的地下水资源不 符合环保要求，并且受环境影响严重，无法进行精确的水温控 制，从而影响设备的温度可靠运行；水冷螺杆机组能耗较大， 并且需要保证足够的回油压差，从而限制了冷却水温的提高， 能效无法有效获得提高，润滑油系统维护困难，可靠性较差， 机组噪音大，对于环境造成严重的噪音污染。 佳力图公司立项研发工业性水冷磁悬浮离心机组，技术要点如 下： （1）可以实现高能效（比水冷螺杆机组节能 50%以上）； （2）高出水温度（18 度出水甚至更高），适用于腐蚀性流体 介质； （3）无油润滑、免维护特性； （4）低噪音，73 分贝以下。 	 自主研发 	 
15 	 R410A 高能效 机房空调 	 随着制冷剂向 HFC 转变的逐步推进，高效、环保的 R410A 冷 媒，越来越受到人们的关注。佳力图最新研发的 R410A 高能 效机房空调具有以下特点： （1）采用直流变频驱动及应用技术； （2）采用 R410A 环保冷媒； （3）采用模块化设计； （4）将现有机房空调最大冷量提升 10%至 110kW； （5）高可靠性的回油控制技术； （6）EER 值达到 3.0W/W 以上，全年能效比 AEER 高达到 5.5W/W。 	 自主研发 	 
16 	 高能效基站空 调 	 随着国家政策对新基建支持力度的加大，5G 通信基站的需求 量和建设量越来越多。5G 通信基站具备功率高、发热量更大、 	 自主研发 	 

序号 	 技术名称 	 技术描述 	 技术来源 	 
 	  	 布局分散等特点。佳力图高能效基站空调采用 R410A 环保制 冷剂，具备高能效、高显热比的特点，能够更加有效地帮助 5G 基站进行温湿度环境管理。本产品为高效节能环保型产品， 其可实现以下功能：单制冷、制冷恒温、制冷恒湿、以及恒温 恒湿，选配件丰富，可根据不同场所的需求提供完美的空调解 决方案。本产品除了应用于通信基站以外，还可应用于电力、 银行、医院、地铁等对小型精密空调有需求的场所。 	  	 
17 	 热管背板空调 	 近年来，数据中心节能降耗的一个重要方向就是贴近热源进行 冷却。热管背板空调是一种新型高效的制冷设备，可以直接安 装在机柜的面，替换原有的门板。这样可以在机柜内部形成一 个小型的封闭热通道，用于收集温度更高的热空气，从而提升 制冷系统的换热效率；同时，可以实现近距离送风，相比较传 统的房间级机房空调，风机功耗更低。该产品的主要特点： （1）单个热管冷门的制冷量做到 15kW； （2）可以实现 2-30 个换热单元同系统并联运行； （3）单机组的 EER 值高达 90 以上； （4）热管背板与总管之间采用软管连接，并采用高可靠性的 嵌套式密封技术； （5）采用模块化设计，可以实现模块化生产、模块化运输、 模块化调试就位； （6）自主设计高效的纵向换热蒸发器，效率高、阻力小、制 冷剂分配均匀。 	  	 
18 	 ME-E 系列双盘 管冷冻水型机 房空调 	 近年来，随着数据中心的快步建设，冷冻水型机房空调被越来 广泛的应用于数据中心冷却方案中。冷冻水双盘管型机房空调 属于冷冻水机房空调的一个分支。该系列机房空调具有双路冷 冻水供回水，可以实现双盘管互为备份，增加了数据中心机房 的可靠性。通过优化系统设计，冷冻水双盘管型机房空调，可 以实现一路冷冻水，一路自由冷却，在冬季或者过渡季节，可 以使用自然冷源，具有较高的节能意义。该系列产品具有大风 量，大冷量，高显热比等特点， 有效解决用户对于大冷量大 风量冷冻水空调的需求。 	  	 
19 	 ME-E 系列氟泵 	 随着绿色节能数据中心的建设过程中，机房空调节能降耗是主 	  	 

序号 	 技术名称 	 技术描述 	 技术来源 	 
 	 双循环机房空 调 	 要的控制点。在提高机房空调能效的开发过程中的一项重要措 施是充分利用室外自然冷源。ME-E 系列氟泵双循环机房空调 充分利用室外自然冷源，利用原风冷机组的室内机蒸发器和室 外冷凝器，增加泵节能模块。机组具有三种工作模式：压缩机 制冷模式，压缩机氟泵混合制冷模式以及氟泵节能制冷模式。 在室外温度较低的过渡季节，开启混合制冷模式，减小机组的 能耗，提高机组 COP；在冬季或者室外温度较低的季节利用氟 泵节能循环代替压缩机制冷循环，有效的降低了机组的能耗， 提高机组 COP。ME-E 系列双循环式低温空气源节能空调的开 发，在保证大风量，高显热的基础上，进一步的利用室内外微 小的温度差，增加机混合制冷技术以及氟泵节能制冷技术，使 得机组在 20℃以下就具有一定的节能效果。 该产品的关键技术： （1）机组结构的最优化设计； （2）三种运行模式运行开发与设计； （3）采用电子膨胀阀的运行模式及不同模式下的参数设置； （4）采用变频调节的室外风机运转形式； （5）采用变频调节的氟泵运行模式； （6）合理与高度节能的控制逻辑的开发与设计； （7）使得节能机组在全国整个范围内均可以得到应用，即使 在南方地区，全年节能率也能达到 20%以上。 	  	 
20 	 高效 V 型（带水 预冷）风冷冷凝 器 	 机房空调现状：机房空调属于工艺性空调，机房内温湿度精度 	  	 
要求较高。中国地理纬度跨度大，一年四季室外温度变化很大， 	 
在夏季高温工况下，会出现因风冷冷凝器排热能力的下降，机 	 
房内温湿度精度难以保证。本产品具有以下特点： （1）基于高温工况进行研发设计，通过水预冷方案，增加换 热温差，提高风冷冷凝器散热能力，保证高温工况下机房空调 稳定运行； 	 
（2）采用 V 型设计方案，减少 50%占地面积； 	 
（3）提升用户现场的通风效果，消除热岛效应，显著提高机 	 
组实际运行效率。 	 
21 	 螺杆式冷热多 	 空调主机在制冷的同时，会产生大量废热。目前的产品，大多 	  	 

序号 	 技术名称 	 技术描述 	 技术来源 	 
 	 功能一体机 	 是将这部分热量排放到环境中。尤其是在数据中心领域，有稳 定的热源，这为我们进行回收热量用于供暖等用途提供了广阔 的空间。 本产品为城市建筑综合体能源利用率最大化的最佳解决方案， 应用广泛：除了数据中心以外，本产品可应用于综合建筑、医 院综合体、泳池、酒店、工厂等同时需要冷热的场所。以风冷 螺杆式冷水机组为基础产品进行升级设计，可实现制冷、制热、 制冷+热回收等多种运行模式。 关键技术：四通阀换向阀、高效蒸发器、热回收器等，以及相 关控制逻辑。 主要技术指标或经济指标：综合能效 ICOP=(制冷量+热回收 量)/功率，ICOP 最高可实现 6.0 以上。 	  	 
22 	 智能冷热双效 节能机组 	 空调主机在制冷的同时，会产生大量废热。基于这种现状，业 内已有越来越多的厂家注重废热回收：即在供冷的同时，免费 回收冷凝热，用于生活热水。以上技术仅实现了制冷热回收， 并不能实现制热冷回收因此需要一种更为节能的多功能产品。 本产品为智能冷热双效节能产品，其可实现以下功能：单制冷、 单制热、冷热同供，对于同时有冷热需求的建筑，可根据不同 的负荷需求提供完美的冷热解决方案。系统使用三个换热器， 两用一备进行工作。目标是根据客户的冷热量需求，进行全自 动匹配的输出。 关键技术：使用平衡换热器、四通换向阀，三通换向阀、除霜 回路、均压系统以及冷媒量调节的设计、相关控制逻辑。 主要技术指标或经济指标：综合能效 ICOP=(制冷量+制热量)/ 功率，ICOP 最高可实现 8.0 以上。 	  	 
23 	 基于自然冷源 动态管理功能 的模块化风冷 磁悬浮机组 	 磁悬浮离心式压缩机与自然冷源利用相结合，可以实现全年最 有效率制冷需求，其中夏季采用磁悬浮压缩机实现机械制冷的 高能效，过渡季节采用自然冷源预冷与机械制冷结合降低机械 制冷功耗，冬季完全使用自然冷源；通过其高能效、可靠性、 噪音低、维护方便等优势逐步开始替代传统的螺杆机组；数据 中心具有负荷稳定和热流密度大的特点，需要在满载和部分负 荷都具有良好的性能，传统自然冷源利用基于固定的温度切换 	  	 

序号 	 技术名称 	 技术描述 	 技术来源 	 
 	  	 点进行控制，无法根据环境温度、负荷等变化因素进行动态管 	  	 
理切换，并且无法实现智能化预测；针对以上问题，采用风冷 	 
磁悬浮机组，并实现智能化与模块化，将自然冷源的控制与水 	 
温、负荷、环境温度和数据预测进行集成，实现自然冷源动态 	 
管理，从而降低数据中心空调制冷耗能。 	 
机组进行模块化设计，冷量为 350 和 450kw 基本模块；可以 	 
实现 3 个压缩机以上的集中控制，相互通讯，实现压缩机相互 	 
轮转；需要在开发过程中对于制冷系统模块化设计、降膜式蒸 	 
发器设计、冷媒两相分配、压缩机之间通讯配合、压缩机相互 	 
轮转控制、自然冷源动态管理方面（基于不同的地区进行智能 	 
化学习）进行技术攻关。 	 
按照名义工况进行测试可以达到国家节能产品要求，IPLV 方 	 
面处于行业最高水准；此外噪音比传统离心机组低 4 到 5 分贝， 	 
且维护费用低，无需专门的润滑油系统，实现完全无油运行。 	 

主要在研项目情况：

序号 	 项目名称 	 主要内容描述 	 
1 	 带封闭式高效冷却 循环的通信模块 	 （1）针对目前网络运营商的 IDC 机房基建要求，开发专门应用微模 	 
块的列间空调，宽度 300mm，高度方向按客户要求不同可进行定制化 	 
设计。优化结构，优化气流组织设计、优化换热器设计，采用干工况 	 
设计，并在保证性能的前提下进行成本优化工作。 	 
（2）整合包括制冷模块、供配电模块、高压直流、网络、布线、监控 及消防等资源，具备提供微模块整套设计方案的能力； 项目目标及关键技术：根据网络运营商的微模块技术规范，定制专为 	 
微模块而设计的列间空调、冷量分配单元模块；掌握微模块总包技术 	 
要求，形成微模块内部的制冷模块、供配电、监控、基建等的一体化 	 
解决方案。结合微模块的特点，合理设计机型结构，使得产品更方便、 	 
快速、可靠地服务于用户。 	 
2 	 高精度微型定点制 冷机组 	 高精度微型定点制冷机组，在佳力图原有定点制冷的基础上，充分利 	 
用机房室内外的温差，对系统进行了重新的设计，项目的主要内容： （1）根据市场需求，设计不同结构形式的机组； （2）优化系统设计，使得室内、外机得到最优的效果； 	 
（3）最大限度的利用室内外的温差进行节能利用。 	 

序号 	 项目名称 	 主要内容描述 	 
 	  	 机组设计目标：优化系统匹配，使得机组的能效比大于 10。 高精度微型定点制冷机组所采取的关键技术： （1）露点控制技术； （2）微通道换热器技术； （3）制冷剂输送泵防汽化技术； （4）PID 精准控制技术。 	 
3 	 数据中心冷冻站集 中控制系统 	 本项目属于 RDS 平台中的一个重要的、可独立运行的单元模块。主要 内容包括：通讯协议库、末端机型模型库，数据采集硬件构架；主要 调节策略的逻辑流程、调节方向、主要算法；用户交互界面、输入输 出功能模块；实时智能调节插件模型库；大数据的智能分析模块。 平台方面关键技术包括：大数据库的存储和其具有典型非结构化数据 的有效运用，系统与平台接口设计、控制冗余安全设计等。核心部分 为各类冷水机组、冷却系统的不同工况下节能特性分析、参数模型库、 水循环压力、流量、循环泵的变流量控制、自然冷源的合理利用等动 态关联模型、智能学习系统、动态节能策略。 	 
4 	 机房空调 VRF 系 统研究 	 机房空调 VRF 系统是集一拖多技术、节能技术、智能控制技术、网络 控制技术等多种高新技术于一身，与传统空调相比，机房空调 VRF 系 统的一个显著的特点是其单位末端制冷量可调节，主机制冷能力也可 实时通过变频调节技术进行调节，具有显著节能优点。 VRF 系统通过控制压缩机的转速来调整制冷剂的循环流量，通过电子 膨胀阀的自动调节来调整进入室内末端换热器的制冷剂流量，实时地 满足机房内变化的热负荷要求，按需供冷，这样可以有效地降低能耗。 另外，机房空调 VRF 系统还具有系统响应速度快、温度控制平稳、温 度场均匀、室内机形式丰富等种种优点。 	 
5 	 CPU 液冷技术 	 随着超级计算机的发展,芯片的集成度和计算速度不断提高, 能耗也不 断增加,散热问题日趋突显。传统的气冷散热方式是直接移热方式,依靠 单相流体的对流换热方法和强制风冷方法只能用于热流密度不大于 10W/ cm2 的电子器件,对于热流密度大于 10W/ cm2 就显得无能为力。 开发设计目标及主要内容： （1）液冷系统的集成； （2）冷板式、浸没式系统的优缺点研究； （3）液冷系统的设计； 	 

序号 	 项目名称 	 主要内容描述 	 
 	  	 （4）沸腾换热研究； 	 
（5)冷却液冷却研究； 	 
（6）液冷系统应用研究。 	 
6 	 VRF 技术在机房 空调领域的初级应 用 	 数据中心发展方向之一就是绿色节能，当前很多新建数据中心已经有 	 
了明确的能效建设要求。但是目前国内仍旧存在大量的老旧机房，其 	 
能效水平较低，在升级改造过程中，又受到建筑结构或者机房布局导 	 
致的搬运通道狭窄的限制。VRF 机房空调可有效解决老机房无多余摆 	 
放机房空调位置的问题。此外，VRF 机房空调可根据机房的特点，布 	 
置不同型式的制冷末端。结构安装更紧凑，成本更节约，换热效率更 高，且室外占用空间更小。 该项目的主要内容及关键技术： （1）压缩制冷循环的开发与设计； 	 
（2）空调室外机组的开发与设计； 	 
（3）采用无级调节的室外风机运转形式； 	 
（4）空调室内机末端的开发与设计； 	 
（5）压缩机变频直流控制逻辑； 	 
（6）内外机集成控制逻辑的开发与设计。 	 
7 	 预装式集成冷站开 	 随着数据中心快速发展，对于冷源的安全性提出更高要求，一般数据 	 
中心都会针对冷源进行备份，但是针对水系统进行备份始终处于低可 	 
靠性阶段，特别是数据中心服役多年后，水系统可靠性下降，特别是 	 
主管路系统。 	 
开发设计目标及主要内容： 	 
发 	 （1）符合数据中心灾备需求，开发一种可快速部署、集成化的预装式 	 
集成冷站； 	 
（2）将冷水机组、水管路系统、控制系统进行集成，出现灾备需求则 	 
进行快速部署，提供电源和水源即可投入工作，强化数据中心可靠性。 	 
（3）集成数据中心冷冻站控制系统，实现冷冻站节能降耗。 	 
8 	 风冷螺杆四管制冷 热多功能一体机 	 对于综合体建筑，后期运营费用的占比越来越重。为了实现能源利用 	 
率的最大化，提升机组的综合能效，佳力图公司立项研发四管制冷热 多功能一体机。 技术要点如下： 	 
（1）该产品每个系统由 3 套换热器组成，即冷水换热器、热水换热 	 

序号 	 项目名称 	 主要内容描述 	 
 	  	 器和平衡换热器； 	 
（2）核心技术在于机组能根据用户的需求，实现多种运行模式的切 	 
换，同时输出适合的冷热量； 	 
（3）运行模式：单制冷、单制热、冷热模式。其中冷热模式下，可 	 
实现能源利用率最大化，综合能效比高，综合能效比 ICOP=(制冷量+ 	 
制热量)/输入功率； 	 
（4）全系列采用双压缩机设计，可自动平衡每台压缩机的运行时间， 	 
压缩机备用性更好，压缩机逐台启动，启动电流小，减少对电网的冲 	 
击。 	 
9 	 RDS-设备健康智 能管理系统 	 借助于先进的网络技术用户可以方便快捷地组建优质高效的监控系 	 
统，实现远程监控和数据传输，并利用大数据和人工智能技术对设备 	 
进行故障诊断预测和健康管理，从而达到机组合理运行，防止故障发 	 
生，高效节能的效果，便捷地监视生产过程状态是否良好以及过程参 	 
数是否正常等。 	 
本项目的在于解决：设备运行维护中的监测、控制、维保需要分别在 独立的系统中实现，并且相互存在数据孤立的问题。本项目要实现设 备运行维护的监测、控制、故障诊断、故障预测、健康管理以及能源 	 
管理一体化的方案，并且实现相互间的数据交互和数据的指导及数据 	 
驱动控制的目标。重点在开发研究能有效反映设备故障及性能退化程 	 
度的状态参数指标体系，建立有效的 AI 智能模型和学习、联想和记忆 	 
能力；建立不同设备的故障库、案例库，涉及故障预测诊断及预测的 	 
相关知识、设备健康状体评估体系等。 	 
10 	 机房环境数据云平 	 深化开发和部署设备联网管理云服务平台，以及对应的云接入设备， 	 
可以增强设备制造商对生产和销售产品运行状态的监控，同时，提高 	 
用户服务质量，提升企业竞争力。 	 
主要内容：实时将数据传入云端，研发及售服人员在公司即可监控每 	 
台设备的运行状态，针对于大数据分析可改善机组的设计从而提高产 	 
台系统 	 品质量；同时售服人员可根据用户定制的选择为用户提供不同的服务， 	 
包括机组是否需要保养、故障中处理、故障后总结等项目。最终实现 	 
用户档案管理、APP 客服管理、用户 APP 保修管理、在线派工管理、 	 
服务质量在线统计、定期设备运行评估等系列功能。 	 
关键技术： 	 

序号 	 项目名称 	 主要内容描述 	 
 	  	 （1）通过关键数据分析生成设备运行评估报告，对关键运行部件给出 预警机制； （2）实时数据库服务器、应用服务器、WEB 服务器与设备信息档案 库的实时交互； （3）移动端 APP 更新与维护；（4）实时历史报警、事件查询的海量 数据吞吐及数据优化。 	 
11 	 空调物联网 	 物联网在中国受到了全社会极大的关注。大力加强产品网络化、智能 化成为了制造业的核心增值点。佳力图公司作为一家集专业化的机房 环境一体化解决方案综合服务提供商，必须融入当今互联网+及大数据 时代。凭借先进技术、高效安全节能产品、合理解决方案为客户提供 完善服务，是公司未来业务的重中之重。 在公司已开发和部署的设备联网管理云服务平台基础上，进一步深化 全系列设备方便的关联通讯连接、运行、云接入。本项目拟在公司主 要系列产品中推进物联网化，将主要系列产品通过触摸屏扩展或板卡 两种方式与云平台互通互联。建立标准化模板和接口，做到只需要在 触摸屏上设置 IP 地址即可轻松接入云平台管理； 关键技术：标准化协议模板规划和搭建、合适的硬件定制化开发、软 硬件接口标准化。通过标准的统一，使公司建立完善的产品物联网体 系，可将公司主流产品方便、快捷的全纳入云平台进行综合管理。 	 
12 	 无主控制器末端， 一体化控制柜 	 目前微模块数据中心产品已逐渐成为数据中心行业的主流产品，在微 模块通道的建设中通常需要集成空调、机柜、UPS、配电以及动环监 控模块，独自构成一套微小的数据中心环境系统。 因此针对目前的标准微模块系统，可将空调系统的控制与微模块动环 系统进行结合，实现环境监测数据共享，取消微模块列间空调主控制 器，配置远程 I/O，集成控制解决。此方式可以降低成本，整体产品化， 并且通过动环系统的整体环境数据检测，综合调配系统中空调的运行 状态可以做到最大限度的对整个微模块系统进行节能。 关键技术： （1）动环主机与微模块中列间空调远程控制 I/O 设备之间的数据通信 和交互； （2）整体微环境空调调配的控制策略；系统的冗余和安全备份。 	 

序号 	 项目名称 	 主要内容描述 	 
13 	 MS-20 机房空调智 能控制器开发 	 1.MS-20 控制器需满足包括基本控制功能、集成加热加湿功能、 集成 	 
电子膨胀阀功能、 集成风机阵列功能等。 	 
2.接口通用化功能，二代控制器输入输出接口可灵活定义，类似于 DDC 	 
或者 PLC 的接口定义方式。编程方式可按照图形化编程或者模块化编 	 
程的方式来进行实现，底层代码框架封装好，可直接进行编程或模块 调用。 3.控制器主处理器按照 STM32 芯片的构架体系来进行开发，保证控制 	 
器的工作速度和稳定性。 	 
4.MS-20 为主控模块加扩展模块的方式，主控模块和扩展模块按照配 	 
置不同可定义为多种类型，主控模块和扩展模块采用内部专有通讯协 	 
议连接。 	 
14 	 面向 5G 应用的新 	 近年来，国内 IDC 的分布式计算、机架服务器等 IT 和互联网技术快速 	 
发展，底层的数据中心随之也出现了很多新的技术应用，包括列间空 	 
调、自然冷却、高压直流、市电直供电源等，随后若干新技术集成后 	 
出现数据中心微模块概念，推动了微模块数据中心在国内快速发展。 	 
越来越多的新建数据中心采用模块化设计，随着国家新基建政策引导， 	 
数据中心建设必将得到空前发展，微模块数据中心技术将会得到更广 	 
一代智能化微模块 	 泛的应用。模块解决方案。 	 
数据中心开发项目 	 本项目主要内容、目标及关键技术：本产品以微模块整体框架设计作 	 
为主要内容，包括封闭通道的设计、动环监控系统的设计、冷源设计， 	 
实现微模块的快速部署和交付。关键技术是整体交付的周期性以及微 	 
模块运用整体 PUE 的降低，能达到 PUE 值在 1.3 以下。 	 
本项目主要技术指标或经济指标：基于模块化、标准化、快速部署的 	 
理念，场景适应性高，安全高效运行，全年 PUE 降低，达到节能。 	 
15 	 面向 5G 应用的微 型一体化数据中心 开发项目 	 近年来随着数据中心快速发展，全球服务器和存储容量快速增长，数 	 
据中心中 50%的 IT 设备，平均每 2-3 年升级或更新，从市场竞争和资 	 
本运作的角度来看，越来越多的场合，尤其是互联网企业的业务需求， 要求在尽可能短的时间内完成实施和部署，边缘+核心为特点的一体化 数据中心逐渐兴起，显现高可用、高功率、预制式等特征。一体化数 据中心以单柜式集成机柜、UPS、配电、空调、监控、布线等于一体， 	 
机柜前部和后部分别设置了冷、热气流通道，无需额外搭建气流通道， 	 
节省占地空间，统一监控、智能管理。 	 

序号 	 项目名称 	 主要内容描述 	 
 	  	 该项目主要内容、目标及关键技术：本产品以 19 英寸单机柜位载体， 	 
集成 UPS、配电、空调、监控、布线等于一体，实现快速部署和交付。 	 
关键技术是快速交付、移动运维以及即插即用技术。 	 
该项目主要技术指标或经济指标：基于模块化、标准化、快速部署的 	 
理念，场景适应性高，安全高效运行，节能。 	 
16 	 面向 5G 应用的 Micro 型数据中心 开发 	 近年来随着数据中心快速发展，急需 IT 功率 10-75KW，空间紧凑的 	 
小型数据中心的应用。Micro 型数据中心为排柜式数据中心，集成机柜、 	 
UPS、配电、空调、监控、布线等于一体，采用标准 19 英寸、42U 	 
的服务器机柜，机柜前后均采用封闭式设计，形成独立的冷、热气流 	 
通道。Micro 型数据中心解决方案提供丰富的可选配件，实现产品的标 准化、预制化，快速部署。采用高可靠的机房专用空调，全年可靠运 行。国内不少厂家也在宣传 Micro 型数据中心解决方案。 主要内容、目标及关键技术：本产品以 19 英寸机柜和空调形成单排柜 	 
位，集成 UPS、配电、空调、监控、布线等于一体，实现快速部署和 	 
交付。关键技术是快速交付、移动运维以及即插即用技术。 	 
主要技术指标或经济指标：基于模块化、标准化、快速部署的理念， 	 
场景适应性高，安全高效运行，节能。 	 
17 	 集装箱式智能化边 	 近年来，数据中心的建设规模越来越大，出现了不少具有很强的数据 	 
处理能力得超大型数据中心，但数据中心的用户遍及全球，接入方式 	 
和带宽的不同，使得用户访问数据中心的体验完全不同。数据中心建 	 
设得规模再大，访问数据中心的接入带宽却很小，用户依然不能获得 	 
很好的体验。边缘数据中心处于最接近用户的地方，只通过广域网和 	 
核心数据中心保持实时的数据更新，不仅可以避免传递很多的重复数 	 
据，也使得当地用户获得的服务和访问核心数据中心获得的服务没有 	 
缘计算数据中心开 	 差异，直接为用户提供良好的服务。 	 
发项目 	 标准的集装箱式数据中心具有模块化、标准化的整体设计，预置的机 	 
架、配电、不间断电源、电池、制冷、灭火和远程监测等系统，在功 	 
能上可完全替代传统数据中心。同时，与传统方式相比，集装箱数据 	 
中心所需的建设费用可减少一半以上，可在世界任何地方为高密度数 	 
据中心提供快速的扩容能力，还可降低超过 40%的扩容运营费用。集 	 
装箱式智能化边缘计算数据中心理想状况下的 PUE 值可低至 1.25。 	 
主要开发内容、目标及关键技术：在一个箱体里提供含供电、制冷、 	 

序号 	 项目名称 	 主要内容描述 	 
 	  	 监控、消防、安防等完整数据中心功能的解决方案 （柴油发电机为选 	 
项另设）；提供四种成熟的标准机型；20 英尺箱体式标准机型可容纳 	 
4-5 个标准机柜；40 英尺箱体式标准机型可容纳 9-10 个标准机柜。标 	 
准机型的每机柜功率最高可达 10kva，定制机型每机柜功率最高可达 	 
20kva； 高可靠双路冗余的电源结构，N+1 冗余在线维护制冷系统； 	 
无需现场工程，接入网络和电源，立即启用；单机柜功率最大可达到 	 
20kva，可适用于高密度集成 IT 系统；安防门禁、视屏监控、防盗金 	 
属箱体，保证物理数据安全。 	 
18 	 博物馆中温精密空 	 随着国家对文化传承和文化产业发展关注度的提高，博物馆、档案馆、 	 
文物库、高档储藏室、高档酒窖等对应用场景对环境温湿度的要求越 	 
来越高。一般情况下，这些场合需要常年将室内环境控制在干球温度 	 
14℃-18℃、相对湿度 40%-80%。传统的舒适性空调、一般性的恒温 	 
恒湿空调以及一般性的精密空调已经无法满足这种高端仓储类应用 	 
场景的需求。 	 
博物馆中温精密空调可以实现低温及变负荷精确制冷，该项目的关键 	 
技术： 	 
调开发 	 （1）解决系统蒸发温度较低，有可能低至 0℃，及蒸发器有结霜隐患 	 
的问题； 	 
（2）优化机组结构； 	 
（3）采用变频控制技术，精确控制制冷剂流量； 	 
（4）自主研发 7mm 内螺纹翅片管换热器，换热效率更高； 	 
（5）设计可进行模拟量无级调节的大功率加热器； 	 
（6）恒温恒湿精确控制，全年 365 天变负荷稳定高效运行； 	 
（7）合理与高度节能的控制逻辑，机组 EER 在 3.0 以上。 	 
19 	 蒸发冷却式节能机 组开发 	 随着云计算、大数据、移动互联、物联网的发展，作为数据承载的数 	 
据中心规模也越来越大，数据中心设备环境、绿色节能等要求也越来 	 
越苛刻，如何在保证机房中心实现低能耗的正常运行也成为行业内普 遍关注的焦点。一种新的、能降低数据中心能耗的技术即间接蒸发冷 却技术正在国内逐步的得到应用。间接蒸发冷却技术可以减少数据中 	 
心加湿、除湿、加热的能耗，最大程度的降低数据中心空调系统的能 	 
耗。 	 
20 	 高精度变频机房空 	 数据中心发展方向之一就是绿色节能，当前很多新建数据中心已经有 	 

序号 	 项目名称 	 主要内容描述 	 
 	 调开发 	 了明确的能效建设要求。目前行业内常见的 	 
是定频型机房空调，其全年能效空间还有待提高。变频型机房空调是 	 
非常好的定频机型的替代方案。变频型机房空调由于其压缩机不会频 	 
繁开启，会使压缩机保持稳定的工作状态，这可以使空调整体达到节 	 
能 15%-30%的效果。同时，这对噪音的减少和延长空调使用寿命， 	 
有相当明显的作用。而且变频型机房空调可根据房间冷（热）负荷的 	 
变化自动调整压缩机的运转频率，达到设定温度后变频空调以较低的 	 
频率运转，这样可以更加精确的控制室内温度变化，空调的精密性很 	 
强。综上，高精度变频型机房空调，能够有效提升机房的全年运行效 	 
率，具备良好的应用前景和市场需求，可以立项开发。 	 
主要开发目标：将设计全新的模块式结构平台、变流量制冷系统和变 	 
频控制方法，重点侧重于模块化组合方式和高能效比的产业化实现方 	 
法，关键技术包括换热器的流程设计和换热效率提升、制冷系统优化、 	 
控制逻辑优化等。 	 
21 	 具备联网监控功能 大冷量磁悬浮离心 机组开发 	 数据中心单体规模在国内越来越大，数据中心设备环境、绿色节能等 	 
要求也越来越苛刻，如何在保证机房中心实现低能耗的正常运行也成 	 
为行业内普遍关注的焦点；目前比较普遍的制冷方案采用大冷量离心 	 
机组，部分配置变频或者高压变频方案进行调节，但是实际使用过程 	 
中发现负荷调节性存在问题（特别是运行初期），高水温下能效较差 	 
（针对民用工况进行设计），变工况性能较差；从而影响大型数据中 心能效水平的提高。 具备联网监控功能大冷量磁悬浮离心机组可以实现机组具备联网监 控功能，从而简化监控系统对于机组调度，针对数据中心应用进行专 	 
门设计，按照名义工况进行测试可以达到国家节能产品要求，COP、 	 
IPLV 和全年能效进行优化，达到行业最高水平；具备快速启动、来 	 
电自启、快速加载和宽水温适应性，满足数据中心独特要求；此外噪 	 
音比传统离心机组低 4 到 5 分贝，且维护费用低，无需专门的润滑油 	 
系统，实现完全无油运行。 	 
22 	 自然冷源蒸发冷却 磁悬浮离心机组开 发 	 随着国家对数据中心能效要求提高，中小型数据中心受限于自身条件 限制，一般选择氟泵循环或者自然冷却风冷机组作为主要冷源；以上 制冷方案严重受制于自然环境对于制冷系统影响。蒸发冷却螺杆机组 已经开始广泛使用在地铁等领域，取得很好的节能效果，并尝试性在 	 

序号 	 项目名称 	 主要内容描述 	 
 	  	 数据中心领域进行试点，存在无法高效利用自然冷源、高温出水限制、 	 
回油压差限制、维护复杂等问题 	 
自然冷源蒸发冷却磁悬浮离心机组结合蒸发冷凝器、自然冷源、磁悬 	 
浮压缩机的技术优点，可以实现全年的高效制冷循环，该项目的关键 	 
技术： 	 
（1）解决蒸发冷凝器结合自然冷源小型化问题，两者高度集成； 	 
（2）制冷系统高度集成，功能融合； 	 
（3）采用变频控制技术，精确控制水温波动在 0.1 度； 	 
（4）自主研发蒸发冷凝器盘管，换热效率更高； 	 
（5）功能集成，实现高效单冷、自然冷却、混合制冷 3 种模式自动 	 
运行； 	 
（6）满足数据中心高水温、快速启动、来电自启等要求； 	 
（7）合理与高度节能的控制逻辑，机组 COP 和 IPLV 双一级能效。 	 
23 	 工业高温螺杆机组 	 工业领域对于特点的工艺生产领域存在高温需求，并且具有全年运行 	 
的高可靠性要求，目前传统的水冷螺杆机组针对民用环境进行开发， 	 
无法满足 65 度出水温度要求，并且可靠性和智能化程度不足，无法 	 
满足工业智能化要求。 	 
工业高温螺杆机组实现全年的高温热水供应，并可以提供智能化监控 	 
功能，该项目的关键技术： 	 
开发 	 （1）解决高出水温度的制冷系统设计； 	 
（2）回油系统的自动继承； 	 
（3）高冷凝温度和高蒸发温度下的可靠运行； 	 
（4）自主研发冷凝器和蒸发器布管，换热效率更高； 	 
（5）功能集成，实现自动监控； 	 
（6）机组可以满足 80 度出水要求。 	 
24 	 数据机房环境设备 	 数据机房环境物联网关是在提供一个安全、稳定、高效的连接平台， 	 
有利于数据机房快速地实现“设备-设备”、“设备-用户应用”、“设备-云 	 
服务”之间可靠、高并发的数据通信中间层硬件。不仅可以实现设备之 	 
云物联智能通讯网 	 间的互动、设备的数据上报和配置下发，还可以基于规则引擎和云产 	 
关 	 品打通，方便快捷地实现将具有感知、监控能力的各类采集、传感器、 	 
控制板等海量设备数据的存储、互通互联、协调管理以及智能分析。 	 
硬件采用高速、高性能的主流芯片 AM3359 处理器和大容量的存储单 	 

序号 	 项目名称 	 主要内容描述 	 
 	  	 元作为平台，进一步扩展多个串口、CAN 口、以太网、和无线通信接 口。 采用嵌入式工业网络处理器 Cortex-A8 内核，嵌入式 Linux 操作系统 和高效率的网络协议，内存采用 512MB 的 DDR3 SDRAM，256MB 的 NAND FLASH 具备扩展能力； 2 路独立的 10/100/1000 兆以太网 接口，可以支持多数规约，可以远方维护装置； 多路串行接口、2 路 Can 接口、1 路 USB 接口可以实现与智能设备通讯管理； 具备 1 路 GPRS 远程协助、网络数据维护功能； 装置具备一定网络冗余功能。 	 
25 	 数据机房能源管理 	 为积极响应国家电网提出的“用上电”到“用好电”的目标，数据机房系统 	 
在保证冷源需求的前提下，对数据机房供配电系统的电流、电压、有 	 
功、无功、功率因数多路采集，进行实时优化模拟计算，动态寻优在 	 
该工况下系统最低能耗时各设备的最优运行控制参数，从而实现系统 	 
层的节能优化控制。 	 
系统分为两大部分：数采终端（能源测量单元），数据监控系统（能 	 
数据采集系统 	 源实时监控子系统），系统设备采用双核(DSP+MCU)32 位微处理器， 	 
DSP 集中采样计算数据，MCU 负责系统信息管理，同时数据交换采 	 
用 DMA 技术，增强系统的稳定性和运行速度。 	 
能源实时监控子系统主要完成能源数据实时动态监控、趋势图显示和 	 
故障异常报警等几大块功能，帮助用户及时、准确了解能源系统的运 	 
行状态，及时发现、解决问题。 	 
26 	 数据机房变频驱动 	 随着电价和高功率密度 IT 设备能耗的持续上升，数据中心所需的相 	 
关能源成本正日益备受关注。作为能耗第二大户空调系统所产生的功 	 
耗约占数据中心机房所需的总功耗的 23%左右，故越来越倾向选择使 	 
用节能环保的各类变频空调产品。 	 
而大量使用变频调节驱动，使谐波电流和无功电流大量注入电网，严 	 
重威胁了电网和电气设备的正常使用。整个机房的电源质量受到极大 	 
专用 EMI 滤波器 	 影响。所以数据中心对电力系统的谐波无功进行滤波和补偿已成为现 	 
在的研究热门。专用 EMI 滤波器，目的是抑制常见品牌型号 EC 风机、 	 
变频压缩机噪声源的设备发射噪声。 	 
关键技术：模块化系列设计，使产品系列化改型更加便捷；由于谐波 	 
源的多样性，要完全滤除谐波是根难实现的。一方面需要考虑针对特 	 
定设备频率的谐波，高效滤除特定次数谐波，并且同时需避免与电网 	 

序号 	 项目名称 	 主要内容描述 	 
 	  	 发生谐振的可能性。另一方面，也要考虑到实际使用场所和设备的差 	 
异，可进行现场调节；需具备一定动态抑制谐波和补偿无功的功能； 	 
在一定范围内它能对频率和大小都变化的谐波和无功进行补偿，可以 	 
弥补通用无源滤波器的缺点。 	 
27 	 精密空调直流变频 驱动器开发 	 节能环保的变频空调产品对节能减排有着十分重要的意义。从空调系 	 
统的结构上来看可以使用变频技术的主要有压缩机和风机，而变频空 	 
调的关键核心技术在于其内部的驱动压缩机和 EC 风机的电机的变频 	 
驱动技术。 研究出高效节能、环保和具有自主知识产权的直流变频 	 
空调驱动方案已成为许多空调企业的热点课题之一。 	 
主要内容：研究压缩机和 EC 风机的结构模型及其工作原理,剖析压缩 	 
机及 EC 风机的负载特性及驱动要求。针对驱动压机和 EC 风机的永 	 
磁同步电动机的特点，描述静止三相、静止两相与旋转两相坐标系下 的永磁同步电动机的数学模型，利用 id=0 的磁场定向矢量控制策略 作为驱动空调压缩机的永磁同步电动机的基本控制方法。针对抖振现 	 
象，为永磁同步电动机设计来获取速度和位置信息的滑模观测器。研 	 
究永磁同步电动机中有功功率和无功功率的计算方法，并对永磁同步 	 
电动机的有功功率和无功功率与系统稳定运行所需转矩和磁链之间 	 
的内在联系进行分析，提高功率因素。最终完成永磁同步电动机的运 	 
动控制系统的软硬件平台设计，该平台包括功率驱动、数据采集等部 	 
分以及控制板，并可增加物联网通讯接口，可使用手机端 APP 进行 	 
云连接。 	 
二、报告期内主要经营情况
截至 2019 年 12 月 31 日，公司总资产为 139,925.52 万元，归属于母公司股东权益为
78,897.44 万元。报告期内，公司实现营业总收入 6.39 亿元，比上年同期增长 19.46%；实现利
润总额 9,724.09 万元，比上年同期下降 21.08%；实现归属于母公司股东净利润 8,457.30 万元， 比上年同期下降 20.72%，实现扣除非经常性损益后归属于母公司净利润 7,144.11 万元，比上年 同期下降 27.55%。主要原因系以权益结算的股份支付确认的费用总额的增加。
2019 年度权益结算的股份支付确认的费用总额为 4,379.68 万元，影响净利润 3,889.49 万元， 扣除股份支付的影响，2019 年净利润与 2019 年度营业收入增长基本匹配。
(一) 主营业务分析
1. 利润表及现金流量表相关科目变动分析表

单位:元 币种:人民币

科目 	 本期数 	 上年同期数 	 变动比例（%） 	 

营业收入 	 638,757,626.77 	 534,724,545.37 	 19.46% 	 
营业成本 	 406,335,097.86 	 311,910,700.32 	 30.27% 	 
销售费用 	 71,316,323.41 	 60,222,507.13 	 18.42% 	 
管理费用 	 40,972,537.09 	 22,489,755.40 	 82.18% 	 
研发费用 	 29,173,413.61 	 22,788,620.19 	 28.02% 	 
财务费用 	 2,812,198.34 	 -869,898.71 	 423.28% 	 
经营活动产生的现金流量净额 	 232,848,224.81 	 87,121,614.75 	 167.27% 	 
投资活动产生的现金流量净额 	 -65,368,897.16 	 -285,883,363.56 	 77.13% 	 
筹资活动产生的现金流量净额 	 -8,576,592.76 	 47,361,685.00 	 -118.11% 	 
1、营业成本变动原因说明：主要系公司新开拓的机房环境一体化业务毛利率略低，导致营业 成本的增长大于营业收入的增长。
2、管理费用变动原因说明：主要系股权激励摊销所致

天衡会计师事务所（特殊普通合伙）审计，根据《企业会计准则第 11 号——股份支付》
及《企业会计准则第 22 号——金融工具确认和计量》的相关规定，用以换取职工提供的服务的 权益结算的股份支付，以授予职工权益工具在授予日的公允价值计量。限制性股票的公允价值由 授予日公司股票收盘价确定。该公允价值的金额在完成等待期内的服务或达到规定业绩条件才可 行权的情况下，在等待期内以对可行权权益工具数量的最佳估计为基础，摊销计入相关成本或费 用。2018 年度以权益结算的股份支付确认的费用总额为 9,683,034.58 元，其中计入管理费用为 3,957,414.13 元，2019 年度以权益结算的股份支付确认的费用总额为 43,796,826.67 元，其中计
入管理费用为元 21,142,308.67 元，较 2018 年增加 17,184,894.54 元。

3、财务费用变动原因说明:主要系公司新增短期借款产生的利息费用所致。

4、经营活动产生的现金流量净额变动原因说明：报告期内营业收入稳定增长，同时加强供应 商的账期管理，采购付款较上年同期有所减少。
5、投资活动产生的现金流量净额变动原因说明：主要系公司为了保证资金使用安全，减少理 财增加定期存款所致。
6、筹资活动产生的现金流量净额变动原因说明：主要系支付股利所致。

2. 收入和成本分析
√适用 □不适用
报告期内公司实现营业收入 6.39 亿元，较去年增长 19.46%，营业成本 4.06 亿元，较去年增 长 30.27%，主营业务收入保持稳健增长。

(1). 主营业务分行业、分产品、分地区情况
单位:元 币种:人民币

主营业务分行业情况 	 
分行业 	 营业收入 	 营业成本 	 毛利率 	 营业收入 	 营业成本 	 毛利率比 	 

 	  	  	 （%） 	 比上年增 减（%） 	 比上年增 减（%） 	 上年增减 （%） 	 
机房环境控 制领域 	 617,138,395.40 	 395,247,799.90 	 35.95 	 19.69 	 30.33 	 减少 5.23 个百分点 	 
主营业务分产品情况 	 
分产品 	 营业收入 	 营业成本 	 毛利率 （%） 	 营业收入 比上年增 减（%） 	 营业成本 比上年增 减（%） 	 毛利率比 上年增减 （%） 	 
精密空调 	 412,295,497.47 	 252,986,397.69 	 38.64 	 -10.39 	 -7.03 	 减少 2.22 个百分点 	 
冷水机组 	 48,939,141.62 	 39,765,953.86 	 18.74 	 147.10 	 131.22 	 增加 5.88 个百分点 	 
代维服务 	 34,249,163.06 	 11,466,373.06 	 66.52 	 16.32 	 35.37 	 减少 4.71 个百分点 	 
机房环境一 体化产品 	 121,654,593.25 	 91,029,075.29 	 25.17 	 不适用 	 不适用 	 不适用 	 
主营业务分地区情况 	 
分地区 	 营业收入 	 营业成本 	 毛利率 （%） 	 营业收入 比上年增 减（%） 	 营业成本 比上年增 减（%） 	 毛利率比 上年增减 （%） 	 
境内销售 	 603,881,276.89 	 388,699,303.58 	 35.63 	 22.61 	 34.72 	 减少 5.79 个百分点 	 
境外销售 	 13,257,118.51 	 6,548,496.32 	 50.60 	 -21.06 	 -29.23 	 增加 5.70 个百分点 	 

主营业务分行业、分产品、分地区情况的说明
1、冷水机组营业收入较去年增加 147.10%，主要系上期末发出商品及本期产品交付验收所 致。
2、代维服务系维护服务项目，由于市场竞争激烈，毛利率下降及人工服务成本增加所致。

3、机房环境一体化产品系公司 2018 年起新开拓的产品业务，2018 年度订单金额较小，计 入其他业务收入核算，2019 年度订单规模提升，作为单独产品系列归集核算。

(2). 产销量情况分析表
√适用 □不适用

主要产品 	 单位 	 生产量 	 销售量 	 库存量 	 生产量比 	 销售量比 	 库存量比 	 
上年增减 	 上年增减 	 上年增减 	 
（%） 	 （%） 	 （%） 	 
精密空调 	 台套 	 10,329 	 7,933 	 589 	 23.35 	 8.34 	 -11.43 	 
冷水机组 	 台套 	 61 	 84 	 21 	 -32.97 	 121.05 	 40.00 	 

产销量情况说明
1、库存量为期末库存商品数量，未包含发出商品数量。

2、精密空调产量增加，主要系热管背板产品订单增加。
3、冷水机组产量下降，主要系冷水机组销售订单减少所致，冷水机组销量增加，主要系上期 末发出商品及本期产品交付验收所致。

(3). 成本分析表

单位：元

分行业情况 	 
分行业 	 成本构成 项目 	 本期金额 	 本期占总 成本比例 (%) 	 上年同期 金额 	 上年同期 占总成本 比例(%) 	 本期金额 较上年同 期变动比 例(%) 	 情况 说明 	 
机 房 环 境 控制领域 	 直接材料 	 29,388.77 	 74.36 	 22,573.54 	 75.81 	 30.19 	 主要系机房 环境一体化 产品销量增 加所致 	 
机 房 环 境 控制领域 	 直接人工 	 1,276.01 	 3.23 	 1,231.49 	 4.14 	 3.62 	  	 
机 房 环 境 控制领域 	 制造费用 	 746.41 	 1.89 	 764.23 	 2.57 	 -2.33 	  	 
机 房 环 境 控制领域 	 安装成本 	 6,966.95 	 17.63 	 4,361.50 	 14.65 	 59.74 	 主要系机房 环境一体化 产品中安装 成本占比较 大 	 
机 房 环 境 控制领域 	 其他 	 1,146.64 	 2.90 	 847.04 	 2.84 	 35.37 	 主要系代维 收入增加 	 
分产品情况 	 
分产品 	 成本构成 项目 	 本期金额 	 本期占总 成本比例 (%) 	 上年同期 金额 	 上年同期 占总成本 比例(%) 	 本期金额 较上年同 期变动比 例(%) 	 情况 说明 	 
精密空调 	 直接材料 	 19,818.20 	 78.34 	 21,375.13 	 78.55 	 -7.28 	  	 
精密空调 	 直接人工 	 1,176.69 	 4.65 	 1,203.21 	 4.42 	 -2.20 	  	 
精密空调 	 制造费用 	 733.05 	 2.90 	 746.99 	 2.75 	 -1.87 	  	 
精密空调 	 安装成本 	 3,570.70 	 14.11 	 3,885.57 	 14.28 	 -8.10 	  	 
冷水机组 	 直接材料 	 3,536.12 	 88.92 	 1,298.41 	 75.50 	 172.34 	 主要系本期 冷水机组销 量增加所致 	 
冷水机组 	 直接人工 	 99.32 	 2.50 	 28.28 	 1.64 	 251.20 	 主要系本期 冷水机组销 量增加所致 	 
冷水机组 	 制造费用 	 13.36 	 0.34 	 17.24 	 1.00 	 -22.51 	  	 
冷水机组 	 安装成本 	 327.79 	 8.24 	 375.93 	 21.86 	 -12.81 	  	 
代 维 服 务 及 其他 	 直接材料 及其他费 用 	 1,146.64 	 100.00 	 847.04 	 100.00 	 35.37 	 主要系代维 收入增加 	 
机 房 环 境 一 体化产品 	 直接材料 	 6,034.45 	 66.29 	 384.73 	 70.00 	 1,468.48 	 主要系机房 环境一体化 产品销量增 加所致 	 
机 房 环 境 一 	 安装成本 	 3,068.46 	 33.71 	 164.89 	 30.00 	 1,760.96 	 主要系机房 	 

体化产品 	  	  	  	  	  	  	 环境一体化 产品中安装 成本占比较 大 	 

成本分析其他情况说明
1、冷水机组直接材料、直接人工较去年有所增加，主要系上期末发出商品以及本期生产入库 的产品在本期达到验收状态所致，销售收入增加导致相应营业成本增加。2019 年公司继续不断优 化产品性能，逐步增强产品竞争力，努力扩大市场份额。
2、代维服务收入增加导致代维服务成本的增加，小部分服务外包增加了代维服务及其他的成 本。
3、机房环境一体化产品成本增加，主要系销量增加所致。 (4). 主要销售客户及主要供应商情况
√适用 □不适用
前五名客户销售额 38,706.61 万元，占年度销售总额 60.60%；其中前五名客户销售额中关联方 销售额 0 万元，占年度销售总额 0 %。
前五名供应商采购额 10,807.35 万元，占年度采购总额 29.31%；其中前五名供应商采购额中关 联方采购额 0 万元，占年度采购总额 0%。
3. 费用
√适用 □不适用
单位：元

科目 	 本期数 	 上年同期数 	 变动比例（%） 	 
销售费用 	 71,316,323.41 	 60,222,507.13 	 18.42% 	 
管理费用 	 40,972,537.09 	 22,489,755.40 	 82.18% 	 
财务费用 	 2,812,198.34 	 -869,898.71 	 423.28% 	 
1、管理费用变动原因说明：主要系股权激励摊销所致

经天衡会计师事务所（特殊普通合伙）审计，根据《企业会计准则第 11 号——股份支付》
及《企业会计准则第 22 号——金融工具确认和计量》的相关规定，用以换取职工提供的服务的 权益结算的股份支付，以授予职工权益工具在授予日的公允价值计量。限制性股票的公允价值由 授予日公司股票收盘价确定。该公允价值的金额在完成等待期内的服务或达到规定业绩条件才可 行权的情况下，在等待期内以对可行权权益工具数量的最佳估计为基础，摊销计入相关成本或费 用。2018 年度以权益结算的股份支付确认的费用总额为 9,683,034.58 元，其中计入管理费用为 3,957,414.13 元，2019 年度以权益结算的股份支付确认的费用总额为 43,796,826.67 元，其中计
入管理费用为元 21,142,308.67 元，较 2018 年增加 17,184,894.54 元。

2、财务费用变动原因说明：主要系公司新增短期借款产生的利息费用所致。
4. 研发投入
(1). 研发投入情况表
√适用 □不适用

单位：元

本期费用化研发投入 	 29,173,413.61 	 
本期资本化研发投入 	 - 	 
研发投入合计 	 29,173,413.61 	 
研发投入总额占营业收入比例（%） 	 4.57% 	 
公司研发人员的数量 	 58 	 
研发人员数量占公司总人数的比例（%） 	 11.72% 	 
研发投入资本化的比重（%） 	 - 	 

(2). 情况说明
√适用 □不适用
1、以上研发人员特指在公司研发中心专业从事研发人员。

2、研发投入总额占营业收入的比例计算中，营业收入的计算口径为公司合并财务报表营业总 收入。研发人员数量占公司总数的比例计算中，总人数的计算口径为报告期末公司（含子公司） 合计人数。

5. 现金流
√适用 □不适用
单位：元

科目 	 本期数 	 上年同期数 	 变动比例（%） 	 
经营活动产生的现金 流量净额 	 232,848,224.81 	 87,121,614.75 	 167.27% 	 
投资活动产生的现金 流量净额 	 -65,368,897.16 	 -285,883,363.56 	 -77.13% 	 
筹资活动产生的现金 流量净额 	 -8,576,592.76 	 47,361,685.00 	 -118.11% 	 
1、经营活动产生的现金流量净额变动原因说明：报告期内营业收入稳定增长，同时加强供 应商的账期管理，采购付款较上年同期有所减少。
2、投资活动产生的现金流量净额变动原因说明：主要系公司为了保证资金使用安全，减少 理财增加定期存款所致。
3、筹资活动产生的现金流量净额变动原因说明：主要系支付股利所致。

(二) 非主营业务导致利润重大变化的说明
□适用 √不适用

(三) 资产、负债情况分析
√适用 □不适用 1. 资产及负债状况

单位：元

项目名称 	 本期期末数 	 本期期末 数占总资 产的比例 （%） 	 上期期末数 	 上期期末 数占总资 产的比例 （%） 	 本期期末 金额较上 期期末变 动比例 （%） 	 情况说明 	 
货币资金 	 578,038,918.74 	 41.31% 	 95,269,378.34 	 8.69% 	 507% 	 主要系公司为 了保证资金使 用安全，减少 理财增加定期 存款所致。 	 
交易性金融资产 	 132,174,575.34 	 9.45% 	  	 0.00% 	 100% 	 执行新金融 准则，列报发 生改变 	 
应收票据 	 1,165,766.63 	 0.08% 	 15,708,221.15 	 1.43% 	 -93% 	 主要系提高 票据使用率 	 
应收账款 	 236,275,839.99 	 16.89% 	 135,077,268.84 	 12.32% 	 75% 	 主要系机房 环境一体化 产品收入增 加所致 	 
应收款项融资 	 2,959,320.98 	 0.21% 	  	 0.00% 	 100% 	 执行新金融 准则，列报发 生改变 	 
其他流动资产 	 4,795,914.60 	 0.34% 	 404,549,528.27 	 36.89% 	 -99% 	 主要根据新 金融准则，将 理财产品调 整至交易性 金融资产 	 
长期股权投资 	 23,999,722.54 	 1.72% 	  	 0.00% 	 100% 	 主要系对联 营企业追加 投资所致 	 
在建工程 	 4,613,093.21 	 0.33% 	  	 0.00% 	 100% 	 在建工程增 加所致 	 
递延所得税资产 	 16,948,146.21 	 1.21% 	 12,010,685.65 	 1.10% 	 41% 	 主要系股份 支付导致的 可抵扣暂时 性差异所致 	 
其他非流动资产 	 449,380.00 	 0.03% 	 1,511,641.97 	 0.14% 	 -70% 	 主要系固定 资产转固所 致 	 
应付票据 	 92,963,367.70 	 6.64% 	  	 0.00% 	 100% 	 主要系期末 开具的票据 较多 	 
预收款项 	 166,602,805.12 	 11.91% 	 102,670,752.70 	 9.36% 	 62% 	 主要系公司 回款周期所 致。 	 
其他应付款 	 79,290,868.22 	 5.67% 	 46,596,501.75 	 4.25% 	 70% 	 主要系股权 激励增加所 致 	 
递延所得税负债 	 326,186.30 	 0.02% 	  	 0.00% 	 100% 	 主要系交易 性金融资产 公允价值变 动导致的交 易性金融资 产公允价值 变动所致 	 
库存股 	 64,247,178.00 	 4.59% 	 34,616,960.00 	 3.16% 	 86% 	 主要系股权 激励增加所 	 

 	  	  	  	  	  	 致 	 
其他说明
无

2. 截至报告期末主要资产受限情况
□适用 √不适用

3. 其他说明
□适用 √不适用

(四) 行业经营性信息分析
√适用 □不适用
1、机房环境控制概述 机房环境控制是指数据中心机房内部的湿度、温度、环境监控和管理等一系列活动。IT 设备
中的元器件及集成电路极易受到温湿度、尘埃、有害气体、电磁、雷电等的干扰，为使其可靠运 行，机房必须具备一定的环境条件，机房环境控制行业应运而生。随着通信、互联网等行业的快 速发展，数据在社会经济以及人们生活中的角色越来越重要，为保证数据中心机房的安全运行， 机房环境控制显得尤为重要。
2、机房环境控制行业发展概况 随着国家经济的持续发展，企业信息化建设的速度不断加快以及互联网企业和国计民生相关
产业的快速发展，国内数据中心机房建设规模快速扩大，从而带动了机房环境控制产品的需求。 近年来，机房环境控制行业在下游行业快速发展的刺激下，互联网、云计算、政务大数据、高端 制造研发等成为机房环境控制行业主要成长动力并形成快速发展的格局。
（1）下游通信行业持续快速发展为本行业的发展提供基础保障 随着通信技术和网络技术的快速发展，国家对通信网络运载和服务能力提出更高要求，政府
陆续出台多项政策，鼓励支持宽带和通信网络的发展。
（2）信息经济的发展带动本行业下游数据中心快速发展 随着我国信息化建设步伐的不断加速，以及云计算、物联网等产业的崛起，数据中心作为信
息数据的重要载体，发展速度日益加快。近年来，“两化融合”即信息化和工业化的高层次的深 度结合推进，互联网快速发展，云计算、移动互联、物联网等新兴应用日益融合，不仅引发数据 量的爆发式增长，而且也推动了数据处理方式的巨大变革。传统数据中心要面对能耗、管理效率、 高可用性、安全和业务持续性等一系列挑战，给机房环境控制行业提出了新的课题，同时也带来 巨大的市场机遇。
（3）数据中心节能需求日益增长，给机房环境控制行业带来新方向 在数据中心的爆发式增长的同时，由于能效监控管理、设备控制智能及联动协同等方面跟不
上，能源的大量消耗问题也不容忽视。电力消耗巨大、发热量集中、单位面积空调冷负荷急剧增 加，由此引来的设备运行故障和能耗逐年增加。随着节能减排理念和技术的深入推广，可以利用
自然冷源和室外环境的机房空调、一体化解决方案增长较为迅速，节能型空调及相应的配套综合 解决方案市场将成为行业的新方向。
3、公司所在细分市场概况
（1）机房空调 机房空调是主要应用于机房环境的高精度空调，为数据中心机房等场所提供温度、湿度、空
气洁净度检测服务以及稳定可靠的温度和湿度调节服务，从而达到提高主设备稳定性、可靠性等 目的，具有高显热比、高能效比、高可靠性、高精度等特点，由于可以同时控制机房温度及湿度， 因此也被称作恒温恒湿机房专用空调。
随着信息化建设提速和 IT 应用水平不断提升，电信、银行等重要行业数据中心的建设步伐越 来越快，保险、电力、医疗、交通等行业对数据中心建设需求加大，机房空调市场需求也会持续 旺盛。未来几年，智慧城市、智慧工厂的建设，轨道交通事业的发展，政府、医疗、教育等行业 信息化、智能化要求，将进一步推动机房空调市场的发展。
（2）冷水机组 冷水机组是通过蒸汽压缩或吸收式循环达到制冷效果的物理机器，这些液体能够流过热交换
器达到对空气或设备降温的目的。冷水机组主要包含涡旋、螺杆、普通离心、磁悬浮离心等几个 主要产品种类。磁悬浮离心式冷水机组是冷水机组中的新型产品，与传统的产品相比，具有高能 效、低维护成本、轻机身、低噪音的优点。
目前很多数据中心在结构可靠性、能耗和制冷系统方面尚不能满足扩展和升级的需要，传统 的数据中心正面临转型，绿色、低碳、环保将成为未来数据中心的发展趋势。近几年，国家对节 能环保的要求逐步提高，在机房建设中，冷水机组重新得到大规模应用，甚至在数据中心设计标 准中做出明确建议。在利好政策的刺激下，未来数据中心的制冷技术将以变频节能、自由冷却为 主，通过采用冷水机组的整体解决方案，满足数据中心的全年制冷需求。
中国新建数据中心市场中，冷水机组在中大和超大型数据中心的应用明显优于在小型数据中 心的应用。中大和超大型数据中心比重的增加带动了机房冷水机组市场销量的上升。
4、影响行业发展的政策
（1）国家产业政策支持行业发展 专用设备制造业是国民经济的重要组成之一。国家对专用设备制造业的指导思想是进行结构
性调整，加大产业基础设施和高端产品研发与生产投入力度，扩大产品系列，提高产品质量，形 成明显的规模效益，培育企业的国际化竞争能力。政策导向将加快行业优胜劣汰的进程，促进具 有产品优势、技术优势的企业进一步发展壮大，有利于提升整个行业的技术水平、质量水平和盈 利水平。
2016 年 12 月，国务院发布《“十三五”国家战略性新兴产业发展规划》，明确提出，要充分 利用现有设施，统筹规划大型、超大型数据中心在全国适宜地区布局，有序推进绿色数据中心建 设。推动基于现有各类通信网络实现物联网集约部署。持续强化应急通信能力建设。2016 年 12
月，国务院发布的《“十三五”国家信息化规划》，提出要积极推广节能减排新技术在信息通信行 业的应用，加快推进数据中心、基站等高耗能信息载体的绿色节能改造。同时指出，要适度超前 布局、集约部署云计算数据中心、内容分发网络、物联网设施，实现应用基础设施与宽带网络优 化匹配、有效协同。支持采用可再生能源和节能减排技术建设绿色云计算数据中心。
2017 年 01 月，国务院印发了《“十三五”节能减排综合工作方案》，方案指出，进一步推广 云计算技术应用，新建大型云计算数据中心能源利用效率（PUE）值优于 1.5。支持技术装备和 服务模式创新。打造一批节能环保产业基地，培育一批具有国际竞争力的大型节能环保企业。
2019 年 1 月，工业和信息化部、国家机关事务管理局、国家能源局联合发布《关于加强绿色 数据中心建设的指导意见》加强对新建数据中心在 IT 设备、机架布局、制冷和散热系统、供配电 系统以及清洁能源利用系统等方面的绿色化设计指导。鼓励采用液冷、分布式供电、模块化机房 以及虚拟化、云化 IT 资源等高效系统设计方案，充分考虑动力环境系统与 IT 设备运行状态的精 准适配；鼓励在自有场所建设自然冷源、自有系统余热回收利用或可再生能源发电等清洁能源利 用系统；鼓励应用数值模拟技术进行热场仿真分析，验证设计冷量及机房流场特性。引导大型和 超大型数据中心设计电能使用效率值不高于 1.4。
中共中央政治局常务委员会 2020 年 3 月 4 日召开会议，会议指出，加快推进国家规划已明 确的重大工程和基础设施建设。加大公共卫生服务、应急物资保障领域投入，加快 5G 网络、数 据中心等新型基础建设。
2020 年 4 月 1 日，江苏省政府在南京召开《＜长江三角洲区域一体化发展规划纲要＞江苏 实施方案》，提出加快建设新一代信息基础设施。围绕建设数字经济强省、打造数字长三角，加 快推进 5G 网络建设，基础设施建设进度。
(五) 投资状况分析
1、 对外股权投资总体分析
√适用 □不适用
1、南京佳力图机电技术服务有限公司成立于 2004 年 08